# FROM-URL	TO-URL
/zh-CN/docs/Add-ons/Creating_Custom_Firefox_Extensions_with_the_Mozilla_Build_System	/zh-CN/docs/Mozilla/Add-ons/Creating_Custom_Firefox_Extensions_with_the_Mozilla_Build_System
/zh-CN/docs/Add-ons/Creating_OpenSearch_plugins_for_Firefox	/zh-CN/docs/Mozilla/Add-ons/Creating_OpenSearch_plugins_for_Firefox
/zh-CN/docs/Add-ons/Extension_Frequently_Asked_Questions_move	/zh-CN/docs/Mozilla/Add-ons/Extension_Frequently_Asked_Questions_move
/zh-CN/docs/Add-ons/Extension_Packaging	/zh-CN/docs/Mozilla/Add-ons/Extension_Packaging
/zh-CN/docs/Add-ons/Install_Manifests	/zh-CN/docs/Mozilla/Add-ons/Install_Manifests
/zh-CN/docs/Add-ons/Overlay_Extensions	/zh-CN/docs/Mozilla/Add-ons/Overlay_Extensions
/zh-CN/docs/Add-ons/Overlay_Extensions/XUL_School-840092-dup	/zh-CN/docs/Mozilla/Add-ons/Overlay_Extensions/XUL_School
/zh-CN/docs/Add-ons/Overlay_Extensions/XUL_School-840092-dup/Adding_Events_and_Commands	/zh-CN/docs/Mozilla/Add-ons/Overlay_Extensions/XUL_School/Adding_Events_and_Commands
/zh-CN/docs/Add-ons/Overlay_Extensions/XUL_School-840092-dup/Adding_Toolbars_and_Toolbar_Buttons	/zh-CN/docs/Mozilla/Add-ons/Overlay_Extensions/XUL_School/Adding_Toolbars_and_Toolbar_Buttons
/zh-CN/docs/Add-ons/Overlay_Extensions/XUL_School-840092-dup/Adding_menus_and_submenus	/zh-CN/docs/Mozilla/Add-ons/Overlay_Extensions/XUL_School/Adding_menus_and_submenus
/zh-CN/docs/Add-ons/Overlay_Extensions/XUL_School-840092-dup/Getting_Started_with_Firefox_Extensions	/zh-CN/docs/Mozilla/Add-ons/Overlay_Extensions/XUL_School/Getting_Started_with_Firefox_Extensions
/zh-CN/docs/Add-ons/Overlay_Extensions/XUL_School-840092-dup/Introduction	/zh-CN/docs/Mozilla/Add-ons/Overlay_Extensions/XUL_School/Introduction
/zh-CN/docs/Add-ons/Overlay_Extensions/XUL_School-840092-dup/JavaScript_Object_Management	/zh-CN/docs/Mozilla/Add-ons/Overlay_Extensions/XUL_School/JavaScript_Object_Management
/zh-CN/docs/Add-ons/Overlay_Extensions/XUL_School-840092-dup/Setting_Up_a_Development_Environment	/zh-CN/docs/Mozilla/Add-ons/Overlay_Extensions/XUL_School/Setting_Up_a_Development_Environment
/zh-CN/docs/Add-ons/Overlay_Extensions/XUL_School-840092-dup/The_Essentials_of_an_Extension	/zh-CN/docs/Mozilla/Add-ons/Overlay_Extensions/XUL_School/The_Essentials_of_an_Extension
/zh-CN/docs/Add-ons/Performance_best_practices_in_extensions	/zh-CN/docs/Mozilla/Add-ons/Performance_best_practices_in_extensions
/zh-CN/docs/Add-ons/Plugins	/zh-CN/docs/Mozilla/Add-ons/Plugins
/zh-CN/docs/Add-ons/Plugins/Gecko_Plugin_API_Reference	/zh-CN/docs/Mozilla/Add-ons/Plugins/Plugin_API_Reference
/zh-CN/docs/Add-ons/Plugins/Gecko_Plugin_API_Reference/Plug-in_Basics	/zh-CN/docs/Mozilla/Add-ons/Plugins/Plugin_API_Reference/Plug-in_Basics
/zh-CN/docs/Add-ons/Plugins/Gecko_Plugin_API_Reference/Plug-in_Development_Overview	/zh-CN/docs/Mozilla/Add-ons/Plugins/Plugin_API_Reference/Plug-in_Development_Overview
/zh-CN/docs/Add-ons/Plugins/Gecko_Plugin_API_Reference/Scripting_plugins	/zh-CN/docs/Mozilla/Add-ons/Plugins/Plugin_API_Reference/Scripting_plugins
/zh-CN/docs/Add-ons/Plugins/Samples_and_Test_Cases	/zh-CN/docs/Mozilla/Add-ons/Plugins/Samples_and_Test_Cases
/zh-CN/docs/Add-ons/Plugins/Shipping_a_plugin_as_a_Toolkit_bundle	/zh-CN/docs/Mozilla/Add-ons/Plugins/Shipping_a_plugin_as_a_Toolkit_bundle
/zh-CN/docs/Add-ons/SDK	/zh-CN/docs/Mozilla/Add-ons/SDK
/zh-CN/docs/Add-ons/SDK/Builder	/zh-CN/docs/Mozilla/Add-ons/SDK/Builder
/zh-CN/docs/Add-ons/SDK/Guides	/zh-CN/docs/Mozilla/Add-ons/SDK/Guides
/zh-CN/docs/Add-ons/SDK/Guides/Working_with_Events	/zh-CN/docs/Mozilla/Add-ons/SDK/Guides/Working_with_Events
/zh-CN/docs/Add-ons/SDK/High-Level_APIs	/zh-CN/docs/Mozilla/Add-ons/SDK/High-Level_APIs
/zh-CN/docs/Add-ons/SDK/High-Level_APIs/clipboard	/zh-CN/docs/Mozilla/Add-ons/SDK/High-Level_APIs/clipboard
/zh-CN/docs/Add-ons/SDK/Low-Level_APIs	/zh-CN/docs/Mozilla/Add-ons/SDK/Low-Level_APIs
/zh-CN/docs/Add-ons/SDK/Low-Level_APIs/ui_button_action	/zh-CN/docs/Mozilla/Add-ons/SDK/Low-Level_APIs/ui_button_action
/zh-CN/docs/Add-ons/SDK/Tutorials	/zh-CN/docs/Mozilla/Add-ons/SDK/Tutorials
/zh-CN/docs/Add-ons/SDK/Tutorials/Add_a_Menu_Item_to_Firefox	/zh-CN/docs/Mozilla/Add-ons/SDK/Tutorials/Add_a_Menu_Item_to_Firefox
/zh-CN/docs/Add-ons/SDK/Tutorials/Adding_a_Button_to_the_Toolbar	/zh-CN/docs/Mozilla/Add-ons/SDK/Tutorials/Adding_a_Button_to_the_Toolbar
/zh-CN/docs/Add-ons/SDK/Tutorials/Display_a_Popup	/zh-CN/docs/Mozilla/Add-ons/SDK/Tutorials/Display_a_Popup
/zh-CN/docs/Add-ons/SDK/Tutorials/Getting_Started_(jpm)	/zh-CN/docs/Mozilla/Add-ons/SDK/Tutorials/Getting_Started_(jpm)
/zh-CN/docs/Add-ons/SDK/Tutorials/Getting_started	/zh-CN/docs/Mozilla/Add-ons/SDK/Tutorials/Getting_started
/zh-CN/docs/Add-ons/SDK/Tutorials/Modifying_Web_Pages_Based_on_URL	/zh-CN/docs/Mozilla/Add-ons/SDK/Tutorials/Modifying_Web_Pages_Based_on_URL
/zh-CN/docs/Add-ons/SDK/Tutorials/Troubleshooting	/zh-CN/docs/Mozilla/Add-ons/SDK/Tutorials/Troubleshooting
/zh-CN/docs/Add-ons/SDK/Tutorials/安装	/zh-CN/docs/Mozilla/Add-ons/SDK/Tutorials/Installation
/zh-CN/docs/Add-ons/SDK/Tutorials/添加一个菜单项	/zh-CN/docs/Mozilla/Add-ons/SDK/Tutorials/添加一个菜单项
/zh-CN/docs/Add-ons/Setting_up_extension_development_environment	/zh-CN/docs/Mozilla/Add-ons/Setting_up_extension_development_environment
/zh-CN/docs/Add-ons/Submitting_an_add-on_to_AMO	/zh-CN/docs/Mozilla/Add-ons/Submitting_an_add-on_to_AMO
/zh-CN/docs/Add-ons/Themes	/zh-CN/docs/Mozilla/Add-ons/Themes
/zh-CN/docs/Add-ons/Themes/Obsolete	/zh-CN/docs/Mozilla/Add-ons/Themes/Obsolete
/zh-CN/docs/Add-ons/Themes/Obsolete/Creating_a_Skin_for_Firefox	/zh-CN/docs/Mozilla/Add-ons/Themes/Obsolete/Creating_a_Skin_for_Firefox
/zh-CN/docs/Add-ons/Themes/Obsolete/Creating_a_Skin_for_Firefox/UUID	/zh-CN/docs/Mozilla/Add-ons/Themes/Obsolete/Creating_a_Skin_for_Firefox/UUID
/zh-CN/docs/Add-ons/Themes/Obsolete/Theme_changes_in_Firefox_3	/zh-CN/docs/Mozilla/Add-ons/Themes/Obsolete/Theme_changes_in_Firefox_3
/zh-CN/docs/CSS/CSS3	/zh-CN/docs/Archive/CSS3
/zh-CN/docs/Chrome_Registration	/zh-CN/docs/Mozilla/Chrome_Registration
/zh-CN/docs/Compiling_The_npruntime_Sample_Plugin_in_Visual_Studio	/zh-CN/docs/Archive/Mozilla/Compiling_The_npruntime_Sample_Plugin_in_Visual_Studio
/zh-CN/docs/Creating_Custom_Firefox_Extensions_with_the_Mozilla_Build_System	/zh-CN/docs/Mozilla/Add-ons/Creating_Custom_Firefox_Extensions_with_the_Mozilla_Build_System
/zh-CN/docs/Creating_OpenSearch_plugins_for_Firefox	/zh-CN/docs/Mozilla/Add-ons/Creating_OpenSearch_plugins_for_Firefox
/zh-CN/docs/Creating_XPCOM_Components/Building_the_WebLock_UI	/zh-CN/docs/Mozilla/Tech/XPCOM/Guide/Creating_components/Building_the_WebLock_UI
/zh-CN/docs/Creating_XPCOM_Components/Creating_the_Component_Code	/zh-CN/docs/Mozilla/Tech/XPCOM/Guide/Creating_components/Creating_the_Component_Code
/zh-CN/docs/Creating_XPCOM_Components/Finishing_the_Component	/zh-CN/docs/Mozilla/Tech/XPCOM/Guide/Creating_components/Finishing_the_Component
/zh-CN/docs/Creating_XPCOM_Components/Packaging_WebLock	/zh-CN/docs/Mozilla/Tech/XPCOM/Guide/Creating_components/Packaging_WebLock
/zh-CN/docs/Creating_XPCOM_Components:Building_the_WebLock_UI	/zh-CN/docs/Mozilla/Tech/XPCOM/Guide/Creating_components/Building_the_WebLock_UI
/zh-CN/docs/Creating_XPCOM_Components:Creating_the_Component_Code	/zh-CN/docs/Mozilla/Tech/XPCOM/Guide/Creating_components/Creating_the_Component_Code
/zh-CN/docs/Creating_XPCOM_Components:Finishing_the_Component	/zh-CN/docs/Mozilla/Tech/XPCOM/Guide/Creating_components/Finishing_the_Component
/zh-CN/docs/Creating_XPCOM_Components:Packaging_WebLock	/zh-CN/docs/Mozilla/Tech/XPCOM/Guide/Creating_components/Packaging_WebLock
/zh-CN/docs/DevEdge	/zh-CN/docs/Archive/Meta_docs/DevEdge
/zh-CN/docs/Developing_add-ons	/zh-CN/docs/Archive/Add-ons/Developing_add-ons
/zh-CN/docs/Downloading_JSON_and_JavaScript_in_extensions	/zh-CN/docs/Archive/Add-ons/Downloading_JSON_and_JavaScript_in_extensions
/zh-CN/docs/E4X	/zh-CN/docs/Archive/Web/E4X
/zh-CN/docs/E4X-840092-dup	/zh-CN/docs/Archive/Web/E4X
/zh-CN/docs/E4X/Processing_XML_with_E4X	/zh-CN/docs/Archive/Web/E4X/Processing_XML_with_E4X
/zh-CN/docs/E4X/Processing_XML_with_E4X-840092-dup	/zh-CN/docs/Archive/Web/E4X/Processing_XML_with_E4X
/zh-CN/docs/E4X_Tutorial	/zh-CN/docs/Archive/Web/E4X_tutorial
/zh-CN/docs/E4X_Tutorial/Accessing_XML_children	/zh-CN/docs/Archive/Web/E4X_tutorial/Accessing_XML_children
/zh-CN/docs/E4X_Tutorial/Descendants_and_Filters	/zh-CN/docs/Archive/Web/E4X_tutorial/Descendants_and_Filters
/zh-CN/docs/E4X_Tutorial/Introduction	/zh-CN/docs/Archive/Web/E4X_tutorial/Introduction
/zh-CN/docs/E4X_Tutorial/Namespaces	/zh-CN/docs/Archive/Web/E4X_tutorial/Namespaces
/zh-CN/docs/E4X_Tutorial/The_global_XML_object	/zh-CN/docs/Archive/Web/E4X_tutorial/The_global_XML_object
/zh-CN/docs/Firefox_3_的界面改动	/zh-CN/docs/Mozilla/Add-ons/Themes/Obsolete/Theme_changes_in_Firefox_3
/zh-CN/docs/Fx_OS_building	/zh-CN/docs/Archive/B2G_OS/Building
/zh-CN/docs/Help_Viewer/Creating_a_Help_Content_Pack	/zh-CN/docs/Archive/Mozilla/Help_viewer/Creating_a_Help_Content_Pack
/zh-CN/docs/Help_Viewer:Creating_a_Help_Content_Pack	/zh-CN/docs/Archive/Mozilla/Help_viewer/Creating_a_Help_Content_Pack
/zh-CN/docs/Images,_Tables,_and_Mysterious_Gaps	/zh-CN/docs/Archive/Misc_top_level/Images,_Tables,_and_Mysterious_Gaps
/zh-CN/docs/Install_Manifests	/zh-CN/docs/Mozilla/Add-ons/Install_Manifests
/zh-CN/docs/Install_Manifests-840092-dup	/zh-CN/docs/Mozilla/Add-ons/Install_Manifests
/zh-CN/docs/Installing_Extensions_and_Themes_From_Web_Pages	/zh-CN/docs/Archive/Add-ons/Installing_Extensions_and_Themes_From_Web_Pages
/zh-CN/docs/Installing_Extensions_and_Themes_From_Web_Pages(从网页安装扩展和主题)	/zh-CN/docs/Archive/Add-ons/Installing_Extensions_and_Themes_From_Web_Pages
/zh-CN/docs/Introduction_to_Layout_in_Mozilla	/zh-CN/docs/Mozilla/Introduction_to_Layout_in_Mozilla
/zh-CN/docs/Introduction_to_the_JavaScript_shell	/zh-CN/docs/Mozilla/Projects/SpiderMonkey/Introduction_to_the_JavaScript_shell
/zh-CN/docs/JSAPI_Reference	/zh-CN/docs/Mozilla/Projects/SpiderMonkey/JSAPI_reference/JS_NewRuntime
/zh-CN/docs/JSAPI_参考	/zh-CN/docs/Mozilla/Projects/SpiderMonkey/JSAPI_reference
/zh-CN/docs/JSClass	/zh-CN/docs/Mozilla/Projects/SpiderMonkey/JSAPI_reference/JSClass
/zh-CN/docs/JSConstDoubleSpec	/zh-CN/docs/Mozilla/Projects/SpiderMonkey/JSAPI_reference/JSConstDoubleSpec
/zh-CN/docs/JSErrorReport	/zh-CN/docs/Mozilla/Projects/SpiderMonkey/JSAPI_reference/JSErrorReport
/zh-CN/docs/JS_DefineConstDoubles	/zh-CN/docs/Mozilla/Projects/SpiderMonkey/JSAPI_reference/JS_DefineConstDoubles
/zh-CN/docs/JavaScript-C引擎嵌入开发指南	/zh-CN/docs/Mozilla/Projects/SpiderMonkey/JavaScript-C引擎嵌入开发指南
/zh-CN/docs/JavaScript/Guide/LiveConnect_Overview	/zh-CN/docs/Archive/Web/LiveConnect
/zh-CN/docs/JavaScript_Tips	/zh-CN/docs/Mozilla/JavaScript_Tips
/zh-CN/docs/JavaScript_code_modules	/zh-CN/docs/Mozilla/JavaScript_code_modules/Geometry.jsm
/zh-CN/docs/JavaScript_code_modules/Services.jsm	/zh-CN/docs/Mozilla/JavaScript_code_modules/Geometry.jsm/Services.jsm
/zh-CN/docs/JavaXPCOM	/zh-CN/docs/Mozilla/Tech/XPCOM/Language_bindings/JavaXPCOM
/zh-CN/docs/JavaXPCOM/使用JavaXPCOM在Java应用程序中嵌入Mozilla	/zh-CN/docs/Mozilla/Tech/XPCOM/Language_bindings/JavaXPCOM/使用JavaXPCOM在Java应用程序中嵌入Mozilla
/zh-CN/docs/JavaXPCOM/开发	/zh-CN/docs/Mozilla/Tech/XPCOM/Language_bindings/JavaXPCOM/开发
/zh-CN/docs/JavaXPCOM:使用JavaXPCOM在Java应用程序中嵌入Mozilla	/zh-CN/docs/Mozilla/Tech/XPCOM/Language_bindings/JavaXPCOM/使用JavaXPCOM在Java应用程序中嵌入Mozilla
/zh-CN/docs/JavaXPCOM:开发	/zh-CN/docs/Mozilla/Tech/XPCOM/Language_bindings/JavaXPCOM/开发
/zh-CN/docs/L10n_Style_Guide	/zh-CN/docs/Mozilla/Localization/L10n_Style_Guide
/zh-CN/docs/Learn_XPI_Installer_Scripting_by_Example	/zh-CN/docs/Archive/Mozilla/XPInstall/Scripting_by_example
/zh-CN/docs/Mozilla/Firefox/企业部署	/zh-CN/docs/Mozilla/Firefox/Enterprise_deployment
/zh-CN/docs/Mozilla/Firefox/开发者_版本	/zh-CN/docs/Mozilla/Firefox/Developer_Edition
/zh-CN/docs/Mozilla/调试	/zh-CN/docs/Mozilla/Debugging
/zh-CN/docs/Multiple_Item_Packaging	/zh-CN/docs/Archive/Add-ons/Multiple_Item_Packaging
/zh-CN/docs/NSPR	/zh-CN/docs/Mozilla/Projects/NSPR
/zh-CN/docs/NsIDOMDocumentXBL	/zh-CN/docs/Archive/Mozilla/XBL/XBL_1.0_Reference/DOM_Interfaces
/zh-CN/docs/NsIIdleService	/zh-CN/docs/Mozilla/Tech/XPCOM/Reference/Interface/nsIIdleService
/zh-CN/docs/NsITimer	/zh-CN/docs/Mozilla/Tech/XPCOM/Reference/Interface/nsITimer
/zh-CN/docs/Observer_Notifications	/zh-CN/docs/Mozilla/Tech/XPCOM/Observer_Notifications
/zh-CN/docs/Participating_in_the_Mozilla_project	/zh-CN/docs/Mozilla/Participating_in_the_Mozilla_project
/zh-CN/docs/PyXPCOM	/zh-CN/docs/Mozilla/Tech/XPCOM/Language_bindings/PyXPCOM
/zh-CN/docs/RDF_Datasource_How-To	/zh-CN/docs/Archive/Mozilla/RDF_Datasource_How-To
/zh-CN/docs/RDF_in_Mozilla_FAQ	/zh-CN/docs/Archive/Web_标准/RDF_in_Mozilla_FAQ
/zh-CN/docs/RDF_数据源_How-To	/zh-CN/docs/Archive/Mozilla/RDF_Datasource_How-To
/zh-CN/docs/RDF_问题集	/zh-CN/docs/Archive/Web_标准/RDF_in_Mozilla_FAQ
/zh-CN/docs/RSS	/zh-CN/docs/Archive/RSS
/zh-CN/docs/RSS/Article	/zh-CN/docs/Archive/RSS/Article
/zh-CN/docs/RSS/Article/Why_Well-Formed_Web_RSS_Module_is_Popular_-_Syndicating_Your_Comments	/zh-CN/docs/Archive/RSS/Article/Why_Well-Formed_Web_RSS_Module_is_Popular_-_Syndicating_Your_Comments
/zh-CN/docs/RSS/文章：为什么"Well-Formed_Web_RSS"模块会流行——对你的评论进行同步	/zh-CN/docs/Archive/RSS/Article/Why_Well-Formed_Web_RSS_Module_is_Popular_-_Syndicating_Your_Comments
/zh-CN/docs/RSS:文章：为什么"Well-Formed_Web_RSS"模块会流行——对你的评论进行同步	/zh-CN/docs/Archive/RSS/Article/Why_Well-Formed_Web_RSS_Module_is_Popular_-_Syndicating_Your_Comments
/zh-CN/docs/Rhino	/zh-CN/docs/Mozilla/Projects/Rhino
/zh-CN/docs/Rhino/BSF	/zh-CN/docs/Mozilla/Projects/Rhino/BSF
/zh-CN/docs/Rhino/Download_Rhino	/zh-CN/docs/Mozilla/Projects/Rhino/Download_Rhino
/zh-CN/docs/Rhino/Overview	/zh-CN/docs/Mozilla/Projects/Rhino/Overview
/zh-CN/docs/Rhino/Rhino_overview	/zh-CN/docs/Mozilla/Projects/Rhino/Requirements_and_Limitations
/zh-CN/docs/Rhino/Rhino概述	/zh-CN/docs/Mozilla/Projects/Rhino/Embedding_tutorial
/zh-CN/docs/Rhino/Shell	/zh-CN/docs/Mozilla/Projects/Rhino/Shell
/zh-CN/docs/Rhino_文档	/zh-CN/docs/Mozilla/Projects/Rhino/Examples
/zh-CN/docs/Rhino_文档n	/zh-CN/docs/Mozilla/Projects/Rhino/Debugger
/zh-CN/docs/Same-origin_policy_for_file:_URIs	/zh-CN/docs/Archive/Misc_top_level/Same-origin_policy_for_file:_URIs
/zh-CN/docs/Security_Considerations2	/zh-CN/docs/Mozilla/Persona/Security_Considerations
/zh-CN/docs/Setting_HTTP_request_headers	/zh-CN/docs/Mozilla/Tech/XPCOM/Setting_HTTP_request_headers
/zh-CN/docs/Setting_up_extension_development_environment	/zh-CN/docs/Mozilla/Add-ons/Setting_up_extension_development_environment
/zh-CN/docs/Shipping_a_plugin_as_an_extension	/zh-CN/docs/Mozilla/Add-ons/Plugins/Shipping_a_plugin_as_a_Toolkit_bundle
/zh-CN/docs/Signing_a_XPI	/zh-CN/docs/Archive/Add-ons/Signing_an_XPI
/zh-CN/docs/Toolkit_API	/zh-CN/docs/Mozilla/Tech/Toolkit_API
/zh-CN/docs/Toolkit_API/extISessionStorage	/zh-CN/docs/Mozilla/Tech/Toolkit_API/extISessionStorage
/zh-CN/docs/Toolkit_version_format	/zh-CN/docs/Mozilla/Toolkit_version_format
/zh-CN/docs/Tools-840092-dup/Firefox_OS_模拟器	/zh-CN/docs/Archive/B2G_OS/Simulator
/zh-CN/docs/Tools-840092-dup/Firefox_OS_模拟器/Simulator_Walkthrough	/zh-CN/docs/Archive/B2G_OS/Simulator/Simulator_Walkthrough
/zh-CN/docs/Tools/Firefox_OS_Simulator	/zh-CN/docs/Archive/B2G_OS/Simulator
/zh-CN/docs/Tools/Firefox_OS_Simulator/Simulator_Walkthrough	/zh-CN/docs/Archive/B2G_OS/Simulator/Simulator_Walkthrough
/zh-CN/docs/Using_XML_Data_Islands_in_Mozilla	/zh-CN/docs/Archive/Misc_top_level/Using_XML_Data_Islands_in_Mozilla
/zh-CN/docs/Using_XPInstall_to_Install_Plugins	/zh-CN/docs/Archive/Mozilla/XPInstall/Using_XPInstall_to_Install_Plugins
/zh-CN/docs/Using_nsCOMPtr	/zh-CN/docs/Mozilla/Tech/XPCOM/Reference/Glue_classes/nsCOMPtr
/zh-CN/docs/Using_nsCOMPtr/Getting_Started_Guide	/zh-CN/docs/Mozilla/Tech/XPCOM/Reference/Glue_classes/nsCOMPtr/Getting_Started_Guide
/zh-CN/docs/Using_the_Right_Markup_to_Invoke_Plugins	/zh-CN/docs/Archive/Web_标准/Using_the_Right_Markup_to_Invoke_Plugins
/zh-CN/docs/Web/API/Navigator.mozHasPendingMessage	/zh-CN/docs/Archive/B2G_OS/API/Navigator/mozHasPendingMessage
/zh-CN/docs/Web/API/Navigator.mozSetMessageHandler	/zh-CN/docs/Archive/B2G_OS/API/Navigator/mozSetMessageHandler
/zh-CN/docs/Web/API/Navigator.mozTelephony	/zh-CN/docs/Archive/B2G_OS/API/Navigator/MozTelephony
/zh-CN/docs/Web/API/Navigator/mozHasPendingMessage	/zh-CN/docs/Archive/B2G_OS/API/Navigator/mozHasPendingMessage
/zh-CN/docs/Web/API/Navigator/mozSetMessageHandler	/zh-CN/docs/Archive/B2G_OS/API/Navigator/mozSetMessageHandler
/zh-CN/docs/Web/API/Navigator/mozTelephony	/zh-CN/docs/Archive/B2G_OS/API/Navigator/MozTelephony
/zh-CN/docs/Web/API/蓝牙状态更改事件	/zh-CN/docs/Archive/B2G_OS/API/BluetoothStatusChangedEvent
/zh-CN/docs/Web/Apps/Advanced_topics	/zh-CN/docs/Archive/Apps/Advanced_topics
/zh-CN/docs/Web/Apps/Build/Icon_implementation_for_apps	/zh-CN/docs/Archive/Apps/Icon_implementation_for_apps
/zh-CN/docs/Web/Apps/Build/应用程序图标的实现	/zh-CN/docs/Archive/Apps/Icon_implementation_for_apps
/zh-CN/docs/Web/Apps/Quickstart/Build	/zh-CN/docs/Archive/B2G_OS/Quickstart
/zh-CN/docs/Web/Apps/Quickstart/Build/Your_first_app	/zh-CN/docs/Archive/B2G_OS/Quickstart/Your_first_app
/zh-CN/docs/Web/Apps/Quickstart/Build/开源Web应用程序简介	/zh-CN/docs/Archive/B2G_OS/Quickstart/开源Web应用程序简介
/zh-CN/docs/Web/CSS/CSS3	/zh-CN/docs/Archive/CSS3
/zh-CN/docs/Web/JavaScript/Guide/LiveConnect_Overview	/zh-CN/docs/Archive/Web/LiveConnect
/zh-CN/docs/Web/JavaScript/Microsoft_Extensions	/zh-CN/docs/Archive/Web/JavaScript/Microsoft_Extensions
/zh-CN/docs/Web/JavaScript/Microsoft_Extensions/ActiveXObject	/zh-CN/docs/Archive/Web/JavaScript/Microsoft_Extensions/ActiveXObject
/zh-CN/docs/Web/JavaScript/Reference/Global_Objects/Proxy/handler/enumerate	/zh-CN/docs/Archive/Web/JavaScript/handler.enumerate
/zh-CN/docs/Web/JavaScript/Reference/Global_Objects/Reflect/enumerate	/zh-CN/docs/Archive/Web/JavaScript/Reflect.enumerate
/zh-CN/docs/Web/JavaScript/Reference/Operators/Legacy_generator_function	/zh-CN/docs/Archive/Web/JavaScript/Legacy_generator_function
/zh-CN/docs/Web/JavaScript/Reference/Statements/Legacy_generator_function	/zh-CN/docs/Archive/Web/JavaScript/Legacy_generator_function_statement
/zh-CN/docs/Web_标准	/zh-CN/docs/Archive/Web_标准
/zh-CN/docs/XBL/XBL_1.0_Reference	/zh-CN/docs/Archive/Mozilla/XBL/XBL_1.0_Reference
/zh-CN/docs/XBL/XBL_1.0_Reference/DOM_Interfaces	/zh-CN/docs/Archive/Mozilla/XBL/XBL_1.0_Reference/DOM_Interfaces
/zh-CN/docs/XPCOM	/zh-CN/docs/Mozilla/Tech/XPCOM
/zh-CN/docs/XPCOM/Array	/zh-CN/docs/Mozilla/Tech/XPCOM/Guide/Arrays
/zh-CN/docs/XPCOM/Hashtables	/zh-CN/docs/Mozilla/Tech/XPCOM/Guide/Hashtables
/zh-CN/docs/XPCOM/Language_Bindings	/zh-CN/docs/Mozilla/Tech/XPCOM/Language_Bindings
/zh-CN/docs/XPCOM/Strings	/zh-CN/docs/Mozilla/Tech/XPCOM/Guide/Internal_strings
/zh-CN/docs/XPCOM:Array	/zh-CN/docs/Mozilla/Tech/XPCOM/Guide/Arrays
/zh-CN/docs/XPCOM:Hashtables	/zh-CN/docs/Mozilla/Tech/XPCOM/Guide/Hashtables
/zh-CN/docs/XPCOM:Language_Bindings	/zh-CN/docs/Mozilla/Tech/XPCOM/Language_Bindings
/zh-CN/docs/XPCOM:Strings	/zh-CN/docs/Mozilla/Tech/XPCOM/Guide/Internal_strings
/zh-CN/docs/XPCOM_Glue	/zh-CN/docs/Mozilla/Tech/XPCOM/Glue
/zh-CN/docs/XPCOM_Interface_Reference	/zh-CN/docs/Mozilla/Tech/XPCOM/Reference/Interface
/zh-CN/docs/XPCOM_Interface_Reference/NsITraceableChannel	/zh-CN/docs/Mozilla/Tech/XPCOM/Reference/Interface/NsITraceableChannel
/zh-CN/docs/XPCOM_Interface_Reference/nsIClipboard	/zh-CN/docs/Mozilla/Tech/XPCOM/Reference/Interface/nsIClipboard
/zh-CN/docs/XPCOM_Interface_Reference/nsIClipboardHelper	/zh-CN/docs/Mozilla/Tech/XPCOM/Reference/Interface/nsIClipboardHelper
/zh-CN/docs/XPCOM_Interface_Reference/nsIConsoleService	/zh-CN/docs/Mozilla/Tech/XPCOM/Reference/Interface/nsIConsoleService
/zh-CN/docs/XPCOM_Interface_Reference/nsIDirectoryServiceProvider	/zh-CN/docs/Mozilla/Tech/XPCOM/Reference/Interface/nsIDirectoryServiceProvider
/zh-CN/docs/XPCOM_Interface_Reference/nsIFile	/zh-CN/docs/Mozilla/Tech/XPCOM/Reference/Interface/nsIFile
/zh-CN/docs/XPCOM_Interface_Reference/nsIFilePicker	/zh-CN/docs/Mozilla/Tech/XPCOM/Reference/Interface/nsIFilePicker
/zh-CN/docs/XPCOM_Interface_Reference/nsIHttpChannel	/zh-CN/docs/Mozilla/Tech/XPCOM/Reference/Interface/nsIHttpChannel
/zh-CN/docs/XPCOM_Interface_Reference/nsILocalFile	/zh-CN/docs/Mozilla/Tech/XPCOM/Reference/Interface/nsILocalFile
/zh-CN/docs/XPCOM_Interface_Reference/nsIProcess	/zh-CN/docs/Mozilla/Tech/XPCOM/Reference/Interface/nsIProcess
/zh-CN/docs/XPCOM_Interface_Reference/nsIPrompt	/zh-CN/docs/Mozilla/Tech/XPCOM/Reference/Interface/nsIPrompt
/zh-CN/docs/XPCOM_Interface_Reference/nsIPromptService	/zh-CN/docs/Mozilla/Tech/XPCOM/Reference/Interface/nsIPromptService
/zh-CN/docs/XPCOM_Interface_Reference/nsIScriptableUnicodeConverter	/zh-CN/docs/Mozilla/Tech/XPCOM/Reference/Interface/nsIScriptableUnicodeConverter
/zh-CN/docs/XPCOM_Interface_Reference/nsISyncMessageSender	/zh-CN/docs/Mozilla/Tech/XPCOM/Reference/Interface/nsISyncMessageSender
/zh-CN/docs/XPConnect	/zh-CN/docs/Mozilla/Tech/XPCOM/Language_bindings/XPConnect
/zh-CN/docs/XPIDL	/zh-CN/docs/Mozilla/Tech/XPIDL
/zh-CN/docs/XPIDL/Syntax	/zh-CN/docs/Mozilla/Tech/XPIDL/Syntax
/zh-CN/docs/XPIDL/xpidl	/zh-CN/docs/Mozilla/Tech/XPIDL/xpidl
/zh-CN/docs/XPIDL:Syntax	/zh-CN/docs/Mozilla/Tech/XPIDL/Syntax
/zh-CN/docs/XPIDL:xpidl	/zh-CN/docs/Mozilla/Tech/XPIDL/xpidl
/zh-CN/docs/XPInstall	/zh-CN/docs/Archive/Mozilla/XPInstall
/zh-CN/docs/XPInstall_API_Reference/Install_Object	/zh-CN/docs/Archive/Mozilla/XPInstall/Reference/Install_Object
/zh-CN/docs/XPInstall_API_Reference/Install_Object/Properties	/zh-CN/docs/Archive/Mozilla/XPInstall/Reference/Install_Object/Properties
/zh-CN/docs/XPInstall_API_Reference:Install_Object	/zh-CN/docs/Archive/Mozilla/XPInstall/Reference/Install_Object
/zh-CN/docs/XPInstall_API_Reference:Install_Object:Properties	/zh-CN/docs/Archive/Mozilla/XPInstall/Reference/Install_Object/Properties
/zh-CN/docs/install.rdf	/zh-CN/docs/Mozilla/Add-ons/Install_Manifests
/zh-CN/docs/nsIAccessibleProvider	/zh-CN/docs/Mozilla/Tech/XPCOM/Reference/Interface/nsIAccessibleProvider
/zh-CN/docs/persona/branding	/zh-CN/docs/Mozilla/Persona/branding
/zh-CN/docs/xbl	/zh-CN/docs/Archive/Mozilla/XBL
/zh-CN/docs/为_Firefox_创建_OpenSearch_插件	/zh-CN/docs/Mozilla/Add-ons/Creating_OpenSearch_plugins_for_Firefox
/zh-CN/docs/主题	/zh-CN/docs/Mozilla/Add-ons/Themes
/zh-CN/docs/创建XPCOM组件/使用XPCOM工具类让事情变得简单	/zh-CN/docs/Mozilla/Tech/XPCOM/Guide/Creating_components/Using_XPCOM_Utilities_to_Make_Things_Easier
/zh-CN/docs/创建XPCOM组件:使用XPCOM工具类让事情变得简单	/zh-CN/docs/Mozilla/Tech/XPCOM/Guide/Creating_components/Using_XPCOM_Utilities_to_Make_Things_Easier
/zh-CN/docs/创建_XPCOM_组件	/zh-CN/docs/Mozilla/Tech/XPCOM/Guide/Creating_components
/zh-CN/docs/创建_XPCOM_组件/Component_Internals	/zh-CN/docs/Mozilla/Tech/XPCOM/Guide/Creating_components/Component_Internals
/zh-CN/docs/创建_XPCOM_组件/XPCOM_简介	/zh-CN/docs/Mozilla/Tech/XPCOM/Guide/Creating_components/An_Overview_of_XPCOM
/zh-CN/docs/创建_XPCOM_组件/使用_XPCOM_组件	/zh-CN/docs/Mozilla/Tech/XPCOM/Guide/Creating_components/Using_XPCOM_Components
/zh-CN/docs/创建_XPCOM_组件/前言	/zh-CN/docs/Mozilla/Tech/XPCOM/Guide/Creating_components/Preface
/zh-CN/docs/创建_XPCOM_组件/建立_Gecko_SDK	/zh-CN/docs/Mozilla/Tech/XPCOM/Guide/Creating_components/Setting_up_the_Gecko_SDK
/zh-CN/docs/创建_XPCOM_组件/开始WebLock	/zh-CN/docs/Mozilla/Tech/XPCOM/Guide/Creating_components/Starting_WebLock
/zh-CN/docs/创建_XPCOM_组件/资源	/zh-CN/docs/Mozilla/Tech/XPCOM/Guide/Creating_components/Resources
/zh-CN/docs/创建_XPCOM_组件:XPCOM_简介	/zh-CN/docs/Mozilla/Tech/XPCOM/Guide/Creating_components/An_Overview_of_XPCOM
/zh-CN/docs/创建_XPCOM_组件:使用_XPCOM_组件	/zh-CN/docs/Mozilla/Tech/XPCOM/Guide/Creating_components/Using_XPCOM_Components
/zh-CN/docs/创建_XPCOM_组件:前言	/zh-CN/docs/Mozilla/Tech/XPCOM/Guide/Creating_components/Preface
/zh-CN/docs/创建_XPCOM_组件:建立_Gecko_SDK	/zh-CN/docs/Mozilla/Tech/XPCOM/Guide/Creating_components/Setting_up_the_Gecko_SDK
/zh-CN/docs/创建_XPCOM_组件:开始WebLock	/zh-CN/docs/Mozilla/Tech/XPCOM/Guide/Creating_components/Starting_WebLock
/zh-CN/docs/创建_XPCOM_组件:资源	/zh-CN/docs/Mozilla/Tech/XPCOM/Guide/Creating_components/Resources
/zh-CN/docs/创建一套Firefox皮肤	/zh-CN/docs/Mozilla/Add-ons/Themes/Obsolete/Creating_a_Skin_for_Firefox/UUID
/zh-CN/docs/创建一套_Firefox_皮肤	/zh-CN/docs/Mozilla/Add-ons/Themes/Obsolete/Creating_a_Skin_for_Firefox
/zh-CN/docs/发行任意元素的hover的起因	/zh-CN/docs/Archive/Web_标准/Issues_Arising_From_Arbitrary-Element_hover
/zh-CN/docs/在您的网页中应用Web标准	/zh-CN/docs/Archive/在您的网页中应用Web标准
/zh-CN/docs/在扩展中下载JSON和JavaScript	/zh-CN/docs/Archive/Add-ons/Downloading_JSON_and_JavaScript_in_extensions
/zh-CN/docs/扩展	/zh-CN/docs/Extensions
/zh-CN/docs/本地化	/zh-CN/docs/Mozilla/Localization/Localizing_extension_descriptions
/zh-CN/docs/本地化扩展描述	/zh-CN/docs/Mozilla/Localization/FAQ
/zh-CN/docs/版本格式说明	/zh-CN/docs/Mozilla/Toolkit_version_format
/zh-CN/docs/调试	/zh-CN/docs/Debugging_JavaScript
/zh-CN/docs/质量保证/Getting_Started_with_IRC	/zh-CN/docs/Archive/Mozilla/Getting_Started_with_IRC
